NO ./textures/empty_wall.xpm
WE ./textures/illuminated_wall.xpm
SO ./textures/empty_wall.xpm
EA ./textures/wall_window.xpm

F 24,24,24
C 24,24,24

111111111111111111111
1N0000000000000000001
111111111111111110001
100000000000000010001
101111111111110010001
101000000000010010001
101011111110010010001
101010000010010010001
101010111010010010001
101010101010010010001
101010101011110010001
101010101000000010001
101010101111111110001
101010100000000000001
101010111111111111101
101010000000000000001
101011111111111111101
100000000000000000001
101111111111111111101
100000000000000000001
111111111111111111111