NO ./textures/empty_wall.xpm
WE ./textures/illuminated_wall.xpm
SO ./textures/empty_wall.xpm
EA ./textures/wall_window.xpm

F 24,24,24
C 24,24,24

1111111111
1E00000001
1000000001
1000000001
1000000001
1000000001
1000000001
1000000001
1000000001
1111111111