NO ./textures/empty_wall.xpm
WE ./textures/illuminated_wall.xpm
SO ./textures/empty_wall.xpm
EA ./textures/wall_window.xpm


F 24,24,24
C 24,24,24

111111111111111111111
1E0000001000000000001
111110111011101111111
100010001010100010001
101111101010101111101
100000101010101000001
111111101010101111111
100000001000100000001
101111111111111111101
101000000000000000101
101011111111111110101
101000000000000000101
101111111111111111101
100000001000100000001
111111101010101111111
100000101010101000001
101111101010101111101
100010001010100010001
111110111011101111111
100000001000000000001
111111111111111111111