NO ./textures/empty_wall.xpm
WE ./textures/illuminated_wall.xpm
SO ./textures/empty_wall.xpm
EA ./textures/wall_window.xpm

F 24,24,24
C 24,24,24

111111111111111111111
110000000111000000011
100000000101000000001
1000000001D1000000001
100000000000000000001
100000000000000000001
100000000000000000001
110000000000000000011
111000000000000000111
111100000000000001111
111110000000000011111
111111000000000111111
111111100000001111111
111111110000011111111
111111111000111111111
1111111111N1111111111
111111111111111111111
111111111111111111111
111111111111111111111
111111111111111111111
111111111111111111111