NO ./textures/empty_wall.xpm
WE ./textures/illuminated_wall.xpm
SO ./textures/empty_wall.xpm
EA ./textures/wall_window.xpm

F 24,24,24
C 24,24,24

        1111111111111111111111111
        1000000000110000000000001
        1011000001110000000000001
        100100000D000000000000001
111111111011000001110000000000001
10000000001100000111D111111111111
11110111111111D11100000010001
11110111111111011101010010001
11000000110101D11100000010001
1000000000000000D000000010001
10000000000000001101010000001
110000011101D1D11111011110N0111
11110111 1110101 101111010001
11111111 1111111 111111111111