NO ./textures/empty_wall.xpm
WE ./textures/illuminated_wall.xpm
SO ./textures/empty_wall.xpm
EA ./textures/wall_window.xpm


F 24,24,24
C 24,24,24

111111111111111111111
1E000000D000000000001
11111D111D111D1111111
100010001010100010001
1D11111D10101D11111D1
100000101010101000001
111111101D1D101111111
100000001000100000001
1011111111D1111111101
101000000000000000101
1010111111D1111110101
101000000000000000101
1011111111D1111111101
100000001000100000001
1111111D10101D1111111
100000101010101000001
101111101010101111101
100010001010100010001
11111D1110111D1111111
10000000D000000000001
111111111111111111111